0000000000000000000000000000000000000000000000000000000000000000000000000000000000000000000000000000000000000000000000000000000000000000000000000000000000000000000000000000000000000000000000000000000000000000000000000000000000000000000000000000000000000000aaa0000000000000000000000000000000000000000000000000000000000000000000000000000000000000000000000000000000000000000000000000000000000000000000000000000000000000000000000000
000000000000000000000000000000000000000000000000000000000000000000000000000000000000000000000000000000000000000000000000000000000000000000000000000000000000000000000000000000000000000000000000000000000000000000000000000000000000000000000000000000000000000000a0000000000000000000000000000000000000000000000000000000000000000000000000000000000000000000000000000000000000000000000000000000000000000000000000000000000000000000000000
000000000000000000000000000000000000000000000000000000000000000000000000000000000000000000000000000000000000000000000000000000000000000000000000000000000000000000000000000000000000000000000000000000000000000000000000000000000000000000000000000000000000000000a0000000000000000000000000000000000000000000000000000000000000000000000000000000000000000000000000000000000000000000000000000000000000000000000000000000000000000000000000
000000000000000000000000000000000000000000000000000000000000000000000000000000000000000000000000000000000000000000000000000000000000000000000000000000000000000000000000000000000000000000000000000000000000000000000000000000000000000000000000000000000000000000a0000000000000000000000000000000000000000000000000000000000000000000000000000000000000000000000000000000000000000000000000000000000000000000000000000000000000000000000000
000000000000a00000000000000000000000000000000000000000000000000000000000000000000000000000000000000000000000000000000000000000000000000000000000000000000000000000000000000000000000000000000000000000000000000000000000000000000000000000000000000000000000000000a0000000000000000000000000000000000000000000000007777777700000000000000000000000000000000000000000000000000000000000000000000000000000000000000000000000000000000000000000
00000000000a000000000000000000000000000000000000000000000000000000000000000000000000000000000000000000000000000000000000000000000000000000000000000000000000000000000000000000000000000000000006666666666600000000000000000000000000000000000000000777000000000000a00000000000000000000000000000000000000000077777788888888777770000000000000000000000000000000000000000000000000000000000000000000000000000aaaa0000000000000000000000000000
0000000000a0000000000000000000000000000000000000000000000000000000000000000000000000000000000000000000000000000000000000000000000000000000000000000000000000000000000000000000000000000000000000066666666660000000000000000000000000070000000070000000000000000000a00000000000000000000007777777777777777777788888800000000888888888888880000000000000000000000000000000000000000000000000000000000000000000000a0000000000000000000000000000
000000000a00000000000000000000000000000000000000000000000000000000000000000000000000000000000000000000000000000000000000000000000000000000000000000000000000000004440000000004444000044444000000000666666666666000000000007770000000000000000000000000000000000000a00000000000000000777778888888888888888888899999900000000000000000000099999900000000000000000000000000000000000000000000000000000000000000000a0000000000000000000000000000
00000000a000000000000000000000000000000000044400000000000000000000000000000000000000000000000000000000444440000000000000000000044444000000000000000044444400000000500004440000000000005550000000000000006666666660000000000800000000000000000000000000000000000000a00000000000777777888889999999999999999999900000000000000000000000000000009999990000000000000000000000000000000000000000000000000000000000000a0000000000000000000000000000
0000000a0000000000000000000000000000000000005000000004400000000000000000000000000000000000000000004000000000000000444444000000005550000000444000000005555000004000000000000000000000000600000000000000000066666666600000000000000000000000000000000000000000000000a00000000777888888999999900000000000000000000000000000000000000000000000000000000000000000000000000000000000000000000000000000000000000000000a0000000000000000000000000000
000000a00000000000000000000000000004440000000000000000000000044400004440000000444400040000444400000000000000000000055550000000000600000000000000000000660000000000000000000000000000000000000000000000000000666666600000000000000000000000000000000000000000000000a00000088888999999900000000000000000000000000000000000000000000000000000000000000000000000000000000000000000000000000000000000000000000000000a0000000000000000000000000000
00000a000000000000000000000000000000500000000000000000000000005000000000000000000000000000000000000000000000000000006600000000000000000000000000000000000000000000000000000000000000000000000000000000000000066666660000000000000000000000000000000000000000000000a00009999999000000000000000000000000000000000700000000777000000000000000000000000000000000000000000000000000000070000000007000000000000000000a6666666666666666660000000000
111111111111111111111111111111100000000000000000000000000000000000000000000000000000000000000000000000000000000000000000000000000000000000000000000000000000000000000000000000000000000000000000000000000000066666660000000000000000000000000000000000000000000000a00099990000000000000000000000000000777000000000777000080000700000007000000000000000000000000000000000000000000000000000000000000000000000000000p00000a0000000600000000000
222222222222222222222222222222210000000000000000000000000000000000000000000000000000000000000000000000000000000000000000000000000000000000000000000000000000000000000000000000000000000000000000000000000000006666666000000000000000000000000000000000000000000000a09999000000000000000000000000000000080000000000080000000000000000000000000000000000000000000000000007000000000000000000000000000000000000000000000000a0000000600000000000
333333333333333333333333333333321000000000000000000000000000000000000000000000000000000000000000000000000000000000000000000000000000000000000000000000000000000000000000000000000000000000000000000000000000006666666600000000000000000000000000000000000000000000a99990000000000000000000000007777000000000700000000000000000000000000000000000000000000000007000000000000000000000000000000000000000700000000000000000c0000000600000000000
3333333333333333333333333333333321110000000000000000000000000000000000000000000000000000000000000000000000000000000000000000000000000000000000000000000000000000000000000000000000000000000000000000000000000006666666600000000000000000000000000000000000000000009990000000000000000000000000000000000000000000000000000000000000000000000000700000000000000000000000000000000070000000000000000000000aaaaaaa666666666666600066666600000000
33333333333333333333333333333333322211000000000000000000000000000000000000000000000000000000000000000000000000000000000000000000000000000000000000000000000000000000000000000000000000044444444444444444444444445555555557777777777777777777000000000000000000000000000000000000000070000077770000000000000000000000000000000000000000000000000000000007000000000000000000000000000000000000000000000000000000006666666666600066660000000000
33333333333333333333333333333333333322111111111111111111111111111111111111111111111111144444444444444444444444444444444444444444444444444444444444444444444444444444444444444444444444555555555555555555555555556666666688888888888888888888999999000000000000000000000000007770000000000000000000000000000000000000000000000000000000000000000000000000000000000099900000000000000000000000000000000000000000006666666666600066660000000000
33333333333333333333333333333333333333222222222222222222222222222222222222222222222222226666666555555555555555555555555555555555555555555555555555555555555555555555555555555555555555666666666666666666666666666666666699999999999999999999999999900000000000000000077700000000000000000000000000000000777777777700000000000000000000000000000000000000000000000000999900000000000000000000000000000000000000666666666666600066666000000000
33333333333333333333333333333333333333333333333333333333333333333333333333333333333333333666666666666666666666666666666666666666666666666666666666666666666666666666666666666666666666666666666666666666666666666666666999999999999999999999999999990000000000099990008000000000000000000000000000000000008888888880000000000000000000000000000000000000000000000000009999000000000000000000000000000000000066666666666666600066666666000000
33333333333333333333333333333333333333333333333333333333333333333333333333333333333333333366666666666666666666666666666666666666666666666666666666666666666666666666666666666666666666666666666666666666666666666666669999999999999999999999999999999000000000009990000000000000000000000000000000000000000999999999000000000000000000000000000000000000000000000000000099999000000000000000000000000000000666666666666666600066666666600000
33333333333333333333333333333333333333333333333333333333333333333333333333333333333333333336666666666666666666666666666666666666666666666666666666666666666666666666666666666666666666666666666666666666666666666666669999999999999999999999999999999900000000000999000000000000000000000000000000000000000099999999990000000000000000000000000000000000000000000000000000999900000000000000000000000000006666666666666666600066666666666000
33333333333333333333333333333333333333333333333333333333333333333333333333333333333333333333666666666666666666666666666666666666666666666666666666666666666666666666666666666666666666666666666666666666666666666666669999999999999999999999999999999900000000000099900000000000000000000000000000000000000000009999999000000000000000000000000000000000000000000000000000099999000000000000000000000000066666666666666666600066666666666000
33333333333333333333333333333333333333333333333333333333333333333333333333333333333333333333366666666666666666666666666666666666666666666666666666666666666666666666666666666666666666666666666666666666666666666666669999999999999999999999999999999900000000000099900000777000000000000000000000000000000000000009999990000000000000000000000000000000000000000000000000009999990000000000000000000000666666666666666666666666666666666600
33333333333333333333333333333333333333333333333333333333333333333333333333333333333333333333366666666666666666666666666666666666666666666666666666666666666666666666666666666666666666666666666666666666666666666666669999999999999999999999999999999900000000000009997777888777777777777777777777777777777777777779999997777777777777777777777777777777777777777777777777799999999444444444444444444446666666666666666666666666666666666660
33333333333333333333333333333333333333333333333333333333333333333333333333333333333333333333366666666666666666666666666666666666666666666666666666666666666666666666666666666666666666666666666666666666666666666666669999999999999999999999999999999990000000000000998888888888888888888888888888888888888888888889999998888888888888888888888888888888888888888888888888888888888555555555555555555556666666666666666666666666666666666666
33333333333333333333333333333333333333333333333333333333333333333333333333333333333333333333666666666666666666666666666666666666666666666666666666666666666666666666666666666666666666666666666666666666666666699999999999999999999999999999999999999999999999999999999999999999999999999999999999999999999999999999999999999999999999999999999999999999999999999999999999999999999666666666666666666666666666666666666666666666666666666666
33333333333333333333333333333333333333333333333333333333333333333333333333333333333333333333666666666666666666666666666666666666666666666666666666666666666666666666666666666666666666666666666666666666666666699999999999999999999999999999999999999999999999999999999999999999999999999999999999999999999999999999999999999999999999999999999999999999999999999999999999999999999666666666666666666666666666666666666666666666666666666666
33333333333333333333333333333333333333333333333333333333333333333333333333333333333333333336666666666666666666666666666666666666666666666666666666666666666666666666666666666666666666666666666666666666666666699999999999999999999999999999999999999999999999999999999999999999999999999999999999999999999999999999999999999999999999999999999999999999999999999999999999999999999666666666666666666666666666666666666666666666666666666666
33333333333333333333333333333333333333333333333333333333333333333333333333333333333333333366666666666666666666666666666666666666666666666666666666666666666666666666666666666666666666666666666666666666666666699999999999999999999999999999999999999999999999999999999999999999999999999999999999999999999999999999999999999999999999999999999999999999999999999999999999999999999666666666666666666666666666666666666666666666666666666666
33333333333333333333333333333333333333333333333333333333333333333333333333333333333333333666666666666666666666666666666666666666666666666666666666666666666666666666666666666666666666666666666666666666666666699999999999999999999999999999999999999999999999999999999999999999999999999999999999999999999999999999999999999999999999999999999999999999999999999999999999999999999666666666666666666666666666666666666666666666666666666666

