000000000000000000000000000000000000000000000000000000000000000000000000000000000000000000000000000000000000000000000000000000000000000000000000000000000000000000000q00000000aaa000000000000000000000
0000000000000000000000000000000000000000000000000000000000000000000000000000000000000000000000000000000000000000000000000000000000000000000000000000000000000000000000000c000000a000000000000000000000
00000000000000000000000000aaaa00000000000000000000000000000000000000000000000000000000000000000000000000000000aaaaaaa00000000000000000000000000000000000000000000000000777770000a000000000000000000000
00000000000000000000000000a00000000000000000000000000000000000000000000000000000000000000000000000000000000000000a00000000000000000000000000000000000000000000000000007888887000a000000000000000000000
00000000000000000000000000a00000000000000000000000000000000000000000000000000000000000000000000000000000000000000a00000000000000000000000000000000000000000000000000078999998700a000000000000000000000
00000000000000000000000000a00000000000000000000000000000000000000000000000000000000000000000000000000000000000000a00000000000000000000000000000000000000000000000000789999999870a000000000000000000000
00000000000000000000000000a00000000000000000000000000000000000000000000000000000000000000000000000000000000000000a000000000000000000000000000000000000000000000000078999999999877777777777777777777777
00000000000000000000000000a00000000000000000000000000000000000000000000000000000000000000000000000000000000000000a000000000000000000000000000000000000000000000000789999999999988888888888888888888888
00000000000000000000000000a00000000000000000000000000000000000000000000000000000000000000000000000000000000000000a000000000000000000000000000000000000000000000007889999999999999999999999999999999999
006666666666000666666666666666666666666666666666666666666666666666000066666666666666666666666600066666666666666666666666666666666666666666666666666666666666000068899999999999999999999999999999999999
006666666666000666666666666666666666666666666666666666666066666666600006666999666666666666666660060666666666666666666666666666666666666666666999666666666660000669999999999999999999999999999999999999
006666666666000666666666666066666666666666666666066666666666666666600006666999666666666666666660006666666666666666666666666666666666666666666999666666666600006669999999999999999999999999999999999999
006666666666000666666666666666666666066666666666666660666666666666660000666999666666666666666660066666666666666666666666666666666666666666666999666666666600006669999999999999999999999999999999999999
006666666666000666666666666666666666666666666666666666666666666666666000666999666666666666666600066666666666666666666666666666666666666666666999666666666600066669999999999999999999999999999999999999
006666666666000666666666660000000000000000000000000000000000000000000000000090000000000000006660000000000000000000000000000000000000000000000090000000000000000009999999999999999999999999999999999999
006666666666000666666666660000000000000000000000000000000000000000000000000090000000000000006660000000000000000000000000000000000000000000000090000000000000000009999999999999999999999999999999999999
006666666666000666666666660000000000000000000000000000000000000000000004000090000000000000006660000000000000000000000000044000400000000000000090000040004400000009999999999999999999999999999999999999
006666666666000666666666660000000000000000000000000000000000000000000000000090000000000000006660000000000000000000000000000000000000000000000090000000000000000009999999999999999999999999999999999999
006666666666aaa666666666660000000000000000000000000000000000000000000000000090000000000000006660000000000000000000004000000000000000440000000090000000000000000009999999999999999999999999999999999999
006666666666000666666666660000000000000000000000000000000000000000000000000000000000000000006660000000000000000000000000000000000000000000000090000040000000000009999999999999999999999999999999999999
006666666666000000000000000000000000000000444000000000000000000000000000000000000000000000006660000000000000000000000000000000000000000000000000000000000000000009999999999999999999999999999999999999
006666660666000000000000000000000000000000000000000000000000000000000000000000000000000000006660000000000000440000000000000000000000000000000000000000000000000009999999999999999999999999999999999999
006666666666000000000000000000000440000000000000000000440000000040000000000000000000000000006660000000000000000000000000000000000000000000000444000000000000000009999999999999999999999999999999999999
006666666666000000000000000000000000000000000000000000000000000000000000044000000000000000006660000000000000000000000000000000000000000000000000000000000000000009999999999999999999999999999999999999
006666666066666666666666660000000000000000000000000000000000000000000000000000000000000000006660000000000000000040000000000000000000000000000000000000000000000009999999999999999999999999999999999999
006666666666666666666666660000000000000000000000000000000000000000000000000000000000000000006660000000000000000000000000000000000000000000000000000000000000000009999999999999999999999999999999999999
006666660666666066666066664000000000000000000000000000000000000000000000000000000000000000006660000000000000000000000000000000000000000000000000000000000000000009999999999999999999999999999999999999
006666666666666666666666665000000000000000000000000000000000000000000000000000000000000000006660000000000000000000000000000000000000000000000000000000000000000009999999999999999999999999999999999999
006666666666666666066666666000000000000000000000000000000000000000000000000000000000000000006660000000000000000000000000000000000000000000000000000000000000000009999999999999999999999999999999999999
006666666666666666066666666000000000000000000000000000000000000000000000000000000000000000006660000000000000000000000000000000000000000000000000000000000000000009999999999999999999999999999999999999
006666666666666666666666666665444444444444444444444444444444444444444444444444444444444444446664444444444444444444444444444444444444444444444444444444444444444449999999999999999999999999999999999999


