000000000000000000000000000000000000000000000888888888888888888888
000000000000000000000000000000000000000000000800000000000000000008
00000000000000000000000000000000000000000000080r000000000000000008
000000000000000000000000000000000000000000000800000000000000000008
000000000000000000000000000000000000000000000800000000000000000008
000000000000000000000000000000000000000000000800000000000000000008
000000000000000000000000000000000000000000000888888888888888iiiii8
000000000000000000000000000000000000000000000000000000000000000000
0000000000000000000000000000000000000000000000000000000000000000000000000000000000000000000000000000000000000000000000000000000000000000000000000000000000000000000000000008888888888800000000000000000000000000000000000000000000000000000000000000000000000000000000000000000000000000000000000
0000000000000000000000000000000000000000000000000000000000000000000000000000000000007000000007777700000000000000000000000000000000000000000000000000000000000000000000000000008000000800000000000000000000000000000000000000000000000000000000000000000000000000000000000000000000000000000000000
0000000000000000000000000000000000000000000000000000000000000000700000000770000000000000000000080000000000000000000000000000000000000000000000000000000000000000000000000000008000000800000000000000000000000000000000000000000000000000000000000000000000000000000000000000000000000000000000000
0000000000000000000000000000000000000000000000000000000000000000000000000000000000000000000000000000000000000000000000000000000000000000000000000000000000000000000000000000008000000800000000000000000000000000000000000000000000000000000000000000000000000000000000000000000000000000000000000
0000000000000000000000000000000000000000000000000000000000000000000000000000000000000000000000000000000000000000000000000000000000000000000000000000000000000000000000000000008000000800000000000000000000000000000000000000000000000000000000000000000000000000000000000000000000000000000000000
0000000000000000000000000000000000000000000000000000000000000000000000000000000000000000070000070000000000000000000000000000000000000000000000000000000000000000000000000000008000000800000000000000000000000000000000000000000000000000000000000000000000000000000000000000000000000000000000000
0000000000000000000000000000000000000000000000000000000000000000000000000000000000000000000000000000000000000000000000000000000000000000000000000000000000000000000000000000008000000888888888888888888888888888888888888888888888888888888888888888888888888888888888888888888888880000000000000
000000000000000000000000000000000000000000000000000000000000000000000000000000000000000000000000000000000000000000000000000000000000000000000000000000000000000000000000000000800000088888888888888888888888888888888888888888888888888888888888888888888888888888888888888888888000000000000aaaa
000000000000000000000000000000000000000000000000000000000000000000000000000000000000000000000000000000000000000000000000000000000000000000000700000000000000000000000000000000000000088888888888888888888888888888888888888888888888888888888888888888888888888888888888888888888000000000000000a
00000000aaa0000000000000000000000000000000000000000000000000000000000000000000000000000000000000000000000000000000000000000000000000000000000000000000700000000000000000000000000000088888888888888888888888888888888888888888888888888888888888888888888888888888888888888888888000000000000000a
00000000a000000000000000000000000000000000000000000000000000000000000000000000000000000000000000000000000000000000000000000070000000000000000000000000000000000007000000000000000000088888888888888888888888888888888888888888888888888888888888888888888888888888888888888888888000000000000000a
00000000a000000000000000000000000000000000000000000000000000000000000000000000000000000000000007777777000000000000000000000000000000070000000000000000000000000000000007000008880008888888888888888888888888888888888888888888888888888888888888888888888888888888888888888888888000000000000000a
00000000a000000000000000000000000000000700000000000000000000000000000000000000000000007000000000888880000000000000000000000000000000000000000000000000000000000000000000000000080008888888888888888888888888888888888888888888888888888888888888888888888888888888888888888888888000000000t00000a
00000000a0000000000000000000000000000000000000000000000000077700000000000000000000000000000000000090000000000070000000000000000000000000000000000000000000000000000000000000000900099999999999999999999999999999999900000000000000000000000000000000000000000000000000aaaaa000000000000000000000a
00000000a0000000000000000000000000000000000000000077000000000000000000000000000770000000000000000090000000000000000000000700000000000000000000000000000000000000000000000000000900099999999999999999999999999999999900000000000000000000000000000000000000000000000000000000000000000000z0000000a
77777777777777777777777777777777700000000000000000000000000000000000000700000000000000000000000000900000000000000000000000000000000000000000000000000000000000000000000000000009000999999999999999999999999999999999000000000000000000000000000070jj070000000000000000000000007777777777777777777
888888888888888888888888888888888000000000000000000000000000000000000000000000000000000000000000009000000070000000000000000000000000000000000000000000000000000000000000000000090009999999999999999999999999999999990000000000000000009000i9000000000000009i0000700000700007000088888888888888888
9999999999999999999999999999999997700000000000000000000000000000000000000000000000000000000000000090000000000000000000000000000000000000000000000000000000000000000000000000000900099999999999999999999999999999999900000000000000000000000000i00000000000000000000000000000000089999999999999999
9999999999999999999999999999999998800000000000000000000000000000000000000000000000000000000000000090000000000000000000000000000000000000000000000000000000000000000000000000000900099999999999999999999999999999999900000000000000000000000000000000000000000000000000000000000089999999999999999
99999999999999999999999999999999999770000000000000000000000000000000000000000000000000000000000000900000000000070000000000000000000000000000000000000000000000000000000000000009000999999999999999999999999999999999000000000000000000i00000000000000000000000000j0000000000000089999999999999999
9999999999999999999999999999999999988000000000000000000000000000000000000000000000000000000000000090000000000000000000000000000000000000000000000000000000000000000000000000000900000000000000000000000000000000000000000000i00009000000000000000000000000000000000000000000000089999999999999999
9999999999999999999999999999999999999770000000000000000000000000000000000000000000000000000000000090000000000000000000000000000000000000000000000000000000000000000000000000000900000000000000000000000000000000000000000000000000000000000000000000000000000000000000000000000089999999999999999
9999999999999999999999999999999999999880000000000000000000000000000000000000000000000000000000000090000000000000000000000000000000000000000000000000000000000000000000000000000900000000000000000000000000000000000000000000000000000000000000000000000000000000000000000000000089999999999999999
9999999999999999999999999999999999999999999999999999999999999999999999999999999999999999999999999999999999999999999999999999999999999999999999999999999999999999999999999999999988888888888888888888888888888888888888888888888888888888888888888888888888888888888888888888888889999999999999999

