00000aaaa0000000000000000000000000000000000000000000000000000000000000000000000000000000000000000000000000000000000000000000000000000000000000000000000000000000000000000066666000000000aaaa0000000000000000000000aaaa
00000a0000000000000000000000000000000000000000000000000000000000000000000000000000000000000000000000000000000000000000000000000000000000000000000000000000000000000000000000006000000000000a0000000000000000000000000a
00000a0000000000000000000000000000000000000000000000000004000000000000000000000000000000000000000000000000000000000000000000000000000000000000000000000000000000000000000000006000000000000aaaaaaaaaaaaaaaaaaaaaaaaaaa
00000a000000000000000000000000000000000000000000000000000400044400000000000000000000444444444444400000000000000000000000000000000000000000000000000000000000400000040000000000600000000000000000000000000000000000000a
00000a000000000000000000000000000000000000000000000000000400000400000000000000000400004000000005550000000000000000000000000000000000000000000000000000000000000000000000000000600000000000000000000000000000000000000a000000000s
00000a0000000000000000000000000000000000000000000000000004000004000000000000000000000040000000006666000000000400000000000000000000000000000000000000000000000000000000000004006000000044440004000040000000000000000y0a
00000a000000000000000000000000000000000000000000000000000000000400000000000000000000005000000000066660000000000000000000000000000000000000000000000004000000000000000000000000600000000000000000000000004000004000444a
00000a000000000000000000000000000000000000000000000000000000000400000000000000000000006000000000006666600000000000000000000040000000000000000000000000000000000000000000000000600000000000000000000000000000000000050a
00000a000000000000000000000000000000000000000000000000000000000400000000000000000000006000000000000066666000000000000000000000000000004000000000000000000000000000000000000000600000000000000000000000000000000000000a
00000a000000000000000000000000000000000000000000000000000000000400000000000000000000006000000000000006666600000000000000000000000000000000000000400000000000000000000000000000600000000000000000000000000000000000000a
00000a000000400000000000000000000000000000000000000000000000000400000000000000000000006000000000000000666666000000000004000000000000000000000000000000000000000000000000000000600000000000000000000000000000000000000a
00000a000000000000040000000004000000440000000000000000000000000000000000000000040000006000000000000000006666600000000000000000000000000000000000000000000000000000000000000000000000000000000000000000000000000000000a
00000a000000000000000000000000000000055500000000000000000000000000000004000000000000000000000000000000000666660000000000000000000000000000000000000000000000000000000000000000000000000000000000000000000000000000000a
00000a000000000000000000000000000000006660000000000000440000000000000000000000000000000000000000000000000006666660000000000000000000000000000000000000000000000000000000000000004000000000000000000000000000000000000a
00000a000000000000000000000000000000000666600000000000000000000000000000000000000000000000000000000000000000666666000000000000000000000000000000000000000000000000000000000000000000000000000000000000000000000000000a
00000a000000000000000000000000000000000066660000000000000000000000000000000000000000000000000000000000000000066666600000000000000000000000000000000000000000000000000000000000000000000000000000000000000000000000000a
00000a0004000000000000000000000000000000066666000000000000000000000000000000000000000000000000000000000000000066666600000000000000000000000000000000000000000000000000000000000000000000000000000000000000000000000aaa
00000a000000000000000000000000000000000000066666000000000000000000000000000000000000000000000000000000000000000666666000000000000000000000000000000000000000000000000000000000000000000000000000000000000000000000000a
00000a000000000000000000000000000000000000006666600000000000000000000000000000000000000000000000000000000000000066666600000000000000000000000000000000000000000000000000000000000000000000000000000000000000000000000a
00000a000000000000000000000000000000000000000666660000000000000000000000000000000000000000000000000000000000000006666660000000000000000000000000000000000000000000000000000000000000000000000000000000000000000000000a
4444444444444444444444444444444444444444444446666664444444444444444444444444444444444444444444444444444444444444466666664444444444444444444444444444444444444444444444444444444444444444444444444444444444444444444444